 # # # # # # # # # # # # # # # # # # # #
 # . . . . . . . . . . . . . . . . . . #
 . . . . . . . . . . . . . . . . . . . #
 # . . . . . . . . . . . . . . . . . . #
 # . . . . . . . . . . . . . . . . . . #
 # . . . . . . . . . . . . . . . . . . #
 # . . . . . . . . . . . . . . . . . . #
 # . . . . . . . . . . . . . . . . . . #
 # . . . . . . . . . . . . . . . . . . #
 # . . . . . . . . . F . . . . . . . . #
 # . . . . . . . . . . . . . . . . . . #
 # . . . . . . . . . . . . . . . . . . #
 # . . . . . . . . . . . . . . . . . . #
 # . . . . . . . . . . . . . . . . . . #
 # . . . . . . . . . . . . . . . . . . #
 # . . . . . . . . . . . . . . . . . . #
 # . . . . . . . . . . . . . . . . . . #
 # . . . . . . . . . . . . . . . . . . #
 # # # # # # # # # # # # # # # # # # # #
