 * # # # * # # # # # # *
 # . . . # . . . . . . #
 # . # . # . # # # # . #
 * # # . # . . . . # . #
 # . . . . # # # . # . #
 * # # # . # F # . # . #
 # . . # . # . # . # . #
 * # . # . # . # . # . #
 # . . . . . . . . # . #
 * # # # # # . # # # . #
 # . . . . . . # . . . #
 * # # # # # # # . # # *
