   0 1 2 3 4 5 6 7 8 9 1011
0  # # # # # # # # # # # #
1  # . . . # . . . . . . #
2  # . # . # . # # # # . #
3  # # # . # . . . . # . #
4  # . . . . # # # . # . #
5  # # # # . # F # . # . #
6  # . . # . # . # . # . #
7  # # . # . # . # . # . #
8  # . . . . . . . . # . #
9  # # # # # # . # # # . #
10 # . . . . . . # . . . #
11 # # # # # # # # . # # #
